L L L L L 
 L L L L L
L S S S L 
 L S S S L
L L L L L 
 L L L L L
L L L L L 
